55555555555555555555555555555555555555555555555555555555555555555
55555555555555555555555555555555555555555555555555555555555555555
55555555555555555555555555555555555555555555555555555555555555555
55555555555555555555555555555555555555555555555555555555555555555
55555555555555555555555555555555555555555555555555555555555555555
55555555555555555555555555555555555555555555555555555555555555555
55555555555555555555555555555555555555555555555555555555555555555
55555555555333333555555555555555555555555555555555555555555555555
55555555533333333355555555555555555555555555555555555555555555555
55555555444455555555555555555555555555555555555555555555555555555
55555555444455555555555555555555555555555555555555555555555555555
55555555444455555555555555555555555555555555555555555555555555555
55555555444455555555555555555555555555555555555555555555555555555
55555555444455555555555555555555555555555555555555555555555555555
55555555444455555555555555555555555555555555555555555555555555555
55555555445555555555555555555555555555555555555555555555555555555
55555555545555555555555555555555555555555555555555555555555555555
55555544444444455555555555555555555555555555555555555555555555555
55555444444444445555555555555555555555555555555555555555555555555
55554444433344444555555555555555555555555555555555555555555555555
55554444322234444555555555555555555555555555555555555555555555555
55554443222223444555555555555555555555555555555555555555555555555
55554443222223444555555555555555555555555555555555555555555555555
55554443222223444444435555555555555555555555555555555555555555555
55554444322234444555555555555555555555555555555555555555555555555
55554444433344444555555555555555555555555555555555555555555555555
55554444444444444555555555555555555555555555555555555555555555555
55555444444444445555555555555555555555555555555555555555555555555
55555554444444455555555555555555555555555555555555555555555555555
55555555555555555555555555555555555555555555555555555555555555555
55555555555555555555555555555555555555555555555555555555555555555
55555555555555555555555555555555555555555555555555555555555555555