22222233111111001111111111111111
22222344444444004555555555555551
22223444444444004555555555555551
22223444444444004554455555555551
22223444444444004555555555555551
22223444444444004545455555555551
22223444444444004555445555555551
22234444444444004455555555555541
22234444444444004444555554455541
22344444444444004444455544445441
33444444444444004444444444444441
00000000000000000000000000000000
00000000000000000000000000000000
14444444444444004444444444444441
14444444444444004444444444444441
14444444444444004444444444444441
14444444444444004444444444444441
14444444444444004444444444444441
14444444444444004444444444444441
14444444444444004444444444444441
14444444444444004444444444444441
14444444444444004444444444444441
14444444444444004444444444444441
11111111111111001111111111111111
