1100111111111111
1000000000000001
1000000000000001
1000000000000001
1000000000000001
1000000000000001
1000000000000001
1000000000000001
1000002222200001
1000002222200001
1000002222200001
1111111111111111
