55555555555555555555555555555555555555555555555555555555555555555
55555455555555555555132222222222222222222234444444444444444444445
55555455554444444445443222222222222222222344444444444444444444445
55555444454555555545544322222222222222223444444444444444444444445
55555555454554444545544432222222222222234444444444444444444444445
55555444454554554545555443333333333333344444444444444444444444445
55555455554554554545555544444440044444444444444444444444444444445
55555444444554554545555555555440044444444444444444444444444444445
55555555555554554545555555555440044444444444444444444444444444445
55555555555554554545555555555440044444444444444444444444444444445
55555555555554554545555555555440044444444444444444444444444444445
55555555555554554545555555555440044444444444444444444444444444445
55555555555554554445555555555440044444444444444444444444444444445
55555555555554555555555555554440044444444444444444444444444444445
54444444444444444444444444444440044444444444444444444444444444445
50000000000000000000000000000000000000000000000000000000000000005
50000000000000000000000000000000000000000000000000000000000000005
54444444444444404444444444444440044444444444444444444444444444445
54444444444444404444444444444440044444444444444444444444444444445
54444444444444404444444444444440044444444444444444444444444444445
54444444411111131111114444444440044444444444444444444444444444445
54444444413333333333314444444440044444444444444444444444444444445
54444444413311131113314444444440044444444444444444444444444444445
54444444413313333313314444444440044444444444444444444444444444445
54444444413313333313314444444440044444444444444444444444444444445
54444444413313333313314444444440044444444444444444444444444444445
54444444413311111113314444444440044444444444444444444444444444445
54444444413333333333314444444440044444444444444444444444444444445
54444444411111111111114444444440044444444444444444444444444444445
54444444444444444444444444444440044444444444444444444444444444445
54444444444444444444444444444440044444444444444444444444444444445
55555555555555555555555555555555555555555555555555555555555555555
