55555555555555555555555555555555555555555555555555555555555555555
55555555555555555555555555555555555555555555555555555555555555555
55555555555555555555555555555555555555555555555555555555555555555
55555555555555555555555555555555555555555555555555555555555555555
55555555555553555555555555555555555555555555555555555555555555555
55555555555554555555555555555555555555555555555555555555555555555
55555555555554555555555555555555555555555555555555555555555555555
55555555555444444555555555455555555555555555555555555555555555555
55555555544444444444444444455555555555555555555555555555555555555
55555555444455555554445555555555555555555555555555555555555555555
55555555444455555554445555555555555555555555555555555555555555555
55555555444455555554433332222235555555555555555555555555555555555
55555555444455555554432222222235555555555555555555555555555555555
55555555444455555554432222222355555555555555555555555555555555555
55555555444455555555443333333335555555555555555555555555555555555
55555555445555555555544444444445555555555555555555555555555555555
55555555545555555555555555555545555555555555555555555555555555555
55555544444444455555555555555545555555555555555555555555555555555
55555444444444445555555555555545555555555555555555555555555555555
55554444433344444555555555511131111555555555555555555555555555555
55554444322234444555555555513333331555555555555555555555555555555
55554443222223444555555555513333331555555555555555555555555555555
55554443222223444555555555513333331555555555555555555555555555555
55554443222223444444435555513333331555555555555555555555555555555
55554444322234444555555555511111111555555555555555555555555555555
55554444433344444555555555555555555555555555555555555555555555555
55554444444444444555555555555555555555555555555555555555555555555
55555444444444445555555555555555555555555555555555555555555555555
55555554444444455555555555555555555555555555555555555555555555555
55555555555555555555555555555555555555555555555555555555555555555
55555555555555555555555555555555555555555555555555555555555555555
55555555555555555555555555555555555555555555555555555555555555555