55555555555555555555555555555555555555555555555555555555555555555
51155455555555555555132222222222222222222234444444444444444444445
51155455554444444445443222222222222222222344444444444444444444445
51155444454555555545544322222222222222223444444444444444444444445
51155555454554444545544432222222222222234444444444444444444444445
51155444454554554545555443333333333333344444444444444444444444445
51155455554554554545555544444440044444444444444444444444444444445
51155444444554554545555555555440044444444444444444444444444444445
51155555555554554545555555555440044444444444444444444444444444445
51155555555554554545555555555440044444444444444444444444444444445
51155555555554554545555555555440044444444444444444444444444444445
51155555555554554545555555555440044444444444444444444444444444445
51155555555554554445555555555440044444444444444444444444444444445
51455555555554555555555555554440044444444444444444444444444444445
54444444444444444444444444444440044444444444444444444444444444445
50000000000000000000000000000000000000000000000000000000000000005
50000000000000000000000000000000000000000000000000000000000000005
54444444444444404444444444444440044444444444444444444444444444445
54444444444444404444444444444440044444444444444444444444444444445
54444444444444404444444444444440044444444444444444444444444444445
54444111111111131111111111114440044444444444444444444444444444445
54444133333333333333333333314440044444444444444444444444444444445
54444133333333333333333333314440044444444444444444444444444444445
54444133333333333333333333314440044444444444444444444444444444445
54444133333333333333333333314440044444444444444444444444444444445
54444133333333333333333333314440044444444444444444444444444444445
54444133333333333333333333314440044444444444444444444444444444445
54444133333333333333333333314440044444444444444444444444444444445
54444111111111111111111111114440044444444444444444444444444444445
54444444444444444444444444444440044444444444444444444444444444445
54444444444444444444444444444440044444444444444444444444444444445
55555555555555555555555555555555555555555555555555555555555555555
