22222233111111111111111111111111
22222344444444004555555555555551
22223444444444004555555555555551
22223444444444004554455555555551
22223444444444004555555555555551
22223444444444004545455555555551
22223444444444004555445555555551
22234444444444004455555555555541
2223444444444400444455555445554111111111111111111111111111111111
223444444444440044444555444454412233344444444440044445555544555411111111111111
334444444444440044444444444444412232230000000000000000000004455541234444444441
100000000000000000000000000000003332223444444444400444455555445554111111111111
1000000000000000000000000000000111111111111111111111111111111111111
1444444444444400444444444444444111111111111111004444444444444441
1111111111111111111111114444444113333333333311004444444444444441
1111111111111111111111114444444113222222222311004444444444444441
1111111111111111111111114444444113222222222311004444444444444441
1111111111111111111111114444444113222222222311004444444444444441
1111111111111111111111114444444113222222222311004444444444444441
1111111111111111111111114444444113222222222311004444444444444441
1111111111111111111111114444444113333333333311004444444444444441
1111111111111111111111114444444444444444444444444444444444444441
1111111111111111111111114444444444444444444444444444444444444441
1111111111111111111111111111111111111111111111111111111111111111