11001111111111111001111111111111
11000000333333333333333000000001
11000000003333333333333000000001
11000000000333333333300000000001
11000000000033333333000000000001
11000000000000000000000000000001
11000000000000000000000000000001
11000000000000000000000000000001
11000002222200000000002222200001
11000002222200000000002222200001
11000002222200000000002222200001
11111111111111000001111111111111
11001111111111000001111111111111
11000000333333000003333000000001
11000000003333333333333000000001
11000000000333333333300000000001
11000000000033333333000000000001
11000000000000000000000000000001
11000000000000000000000000000001
11000000000000000000000000000001
11000002222200000000002222200001
11000002222200000000002222200001
11000002222200000000002222200001
11111111111111111111111111111111
